"filename", "language", "JavaScript", "JSON", "comment", "blank", "total"
"d:\ABDOU\BrokerCrmExpress\app.js", "JavaScript", 78, 0, 6, 9, 93
"d:\ABDOU\BrokerCrmExpress\controllers\clientController.js", "JavaScript", 77, 0, 0, 6, 83
"d:\ABDOU\BrokerCrmExpress\controllers\coProductController.js", "JavaScript", 50, 0, 0, 6, 56
"d:\ABDOU\BrokerCrmExpress\controllers\commandController.js", "JavaScript", 110, 0, 0, 11, 121
"d:\ABDOU\BrokerCrmExpress\controllers\commentController.js", "JavaScript", 86, 0, 0, 6, 92
"d:\ABDOU\BrokerCrmExpress\controllers\companyController.js", "JavaScript", 17, 0, 0, 5, 22
"d:\ABDOU\BrokerCrmExpress\controllers\establishmentController.js", "JavaScript", 15, 0, 0, 5, 20
"d:\ABDOU\BrokerCrmExpress\controllers\expensesConfigController.js", "JavaScript", 47, 0, 0, 5, 52
"d:\ABDOU\BrokerCrmExpress\controllers\expensesDayController.js", "JavaScript", 68, 0, 0, 11, 79
"d:\ABDOU\BrokerCrmExpress\controllers\expensesUserController.js", "JavaScript", 14, 0, 0, 4, 18
"d:\ABDOU\BrokerCrmExpress\controllers\fileUploadController.js", "JavaScript", 61, 0, 6, 13, 80
"d:\ABDOU\BrokerCrmExpress\controllers\goalController.js", "JavaScript", 62, 0, 0, 8, 70
"d:\ABDOU\BrokerCrmExpress\controllers\motivationController.js", "JavaScript", 16, 0, 0, 5, 21
"d:\ABDOU\BrokerCrmExpress\controllers\productController.js", "JavaScript", 50, 0, 0, 6, 56
"d:\ABDOU\BrokerCrmExpress\controllers\reportController.js", "JavaScript", 152, 0, 9, 13, 174
"d:\ABDOU\BrokerCrmExpress\controllers\serviceController.js", "JavaScript", 23, 0, 0, 5, 28
"d:\ABDOU\BrokerCrmExpress\controllers\specialityController.js", "JavaScript", 16, 0, 1, 5, 22
"d:\ABDOU\BrokerCrmExpress\controllers\userController.js", "JavaScript", 314, 0, 0, 43, 357
"d:\ABDOU\BrokerCrmExpress\controllers\visitController.js", "JavaScript", 130, 0, 0, 13, 143
"d:\ABDOU\BrokerCrmExpress\controllers\wilayaController.js", "JavaScript", 26, 0, 0, 6, 32
"d:\ABDOU\BrokerCrmExpress\cronjobs\agenda.js", "JavaScript", 95, 0, 9, 14, 118
"d:\ABDOU\BrokerCrmExpress\cronjobs\expensesDay.js", "JavaScript", 111, 0, 5, 9, 125
"d:\ABDOU\BrokerCrmExpress\middlewares\jwtMiddleware.js", "JavaScript", 13, 0, 0, 3, 16
"d:\ABDOU\BrokerCrmExpress\middlewares\userJwt.js", "JavaScript", 19, 0, 0, 6, 25
"d:\ABDOU\BrokerCrmExpress\models\client.js", "JavaScript", 74, 0, 0, 5, 79
"d:\ABDOU\BrokerCrmExpress\models\coProduct.js", "JavaScript", 45, 0, 0, 4, 49
"d:\ABDOU\BrokerCrmExpress\models\command.js", "JavaScript", 92, 0, 0, 2, 94
"d:\ABDOU\BrokerCrmExpress\models\comment.js", "JavaScript", 22, 0, 0, 4, 26
"d:\ABDOU\BrokerCrmExpress\models\company.js", "JavaScript", 18, 0, 0, 4, 22
"d:\ABDOU\BrokerCrmExpress\models\establishment.js", "JavaScript", 20, 0, 0, 4, 24
"d:\ABDOU\BrokerCrmExpress\models\expensesConfig.js", "JavaScript", 16, 0, 0, 4, 20
"d:\ABDOU\BrokerCrmExpress\models\expensesDay.js", "JavaScript", 64, 0, 0, 2, 66
"d:\ABDOU\BrokerCrmExpress\models\expensesUser.js", "JavaScript", 27, 0, 0, 2, 29
"d:\ABDOU\BrokerCrmExpress\models\file.js", "JavaScript", 18, 0, 0, 4, 22
"d:\ABDOU\BrokerCrmExpress\models\goal.js", "JavaScript", 24, 0, 0, 4, 28
"d:\ABDOU\BrokerCrmExpress\models\motivation.js", "JavaScript", 22, 0, 0, 4, 26
"d:\ABDOU\BrokerCrmExpress\models\product.js", "JavaScript", 45, 0, 0, 4, 49
"d:\ABDOU\BrokerCrmExpress\models\report.js", "JavaScript", 72, 0, 0, 4, 76
"d:\ABDOU\BrokerCrmExpress\models\service.js", "JavaScript", 16, 0, 0, 4, 20
"d:\ABDOU\BrokerCrmExpress\models\speciality.js", "JavaScript", 18, 0, 0, 4, 22
"d:\ABDOU\BrokerCrmExpress\models\todo.js", "JavaScript", 43, 0, 0, 4, 47
"d:\ABDOU\BrokerCrmExpress\models\user.js", "JavaScript", 78, 0, 0, 5, 83
"d:\ABDOU\BrokerCrmExpress\models\version.js", "JavaScript", 25, 0, 0, 4, 29
"d:\ABDOU\BrokerCrmExpress\models\visit.js", "JavaScript", 37, 0, 0, 3, 40
"d:\ABDOU\BrokerCrmExpress\models\wilaya.js", "JavaScript", 12, 0, 0, 4, 16
"d:\ABDOU\BrokerCrmExpress\package-lock.json", "JSON", 0, 3625, 0, 1, 3626
"d:\ABDOU\BrokerCrmExpress\package.json", "JSON", 0, 34, 0, 1, 35
"d:\ABDOU\BrokerCrmExpress\routes\clientRoutes.js", "JavaScript", 9, 0, 1, 3, 13
"d:\ABDOU\BrokerCrmExpress\routes\coProductRoutes.js", "JavaScript", 9, 0, 1, 3, 13
"d:\ABDOU\BrokerCrmExpress\routes\commandRoutes.js", "JavaScript", 8, 0, 0, 3, 11
"d:\ABDOU\BrokerCrmExpress\routes\commentRoutes.js", "JavaScript", 9, 0, 1, 3, 13
"d:\ABDOU\BrokerCrmExpress\routes\companyRoutes.js", "JavaScript", 5, 0, 1, 4, 10
"d:\ABDOU\BrokerCrmExpress\routes\establishmentRoutes.js", "JavaScript", 5, 0, 1, 4, 10
"d:\ABDOU\BrokerCrmExpress\routes\expensesConfigRoutes.js", "JavaScript", 5, 0, 1, 4, 10
"d:\ABDOU\BrokerCrmExpress\routes\expensesDayRoutes.js", "JavaScript", 7, 0, 1, 3, 11
"d:\ABDOU\BrokerCrmExpress\routes\fileRoutes.js", "JavaScript", 7, 0, 1, 4, 12
"d:\ABDOU\BrokerCrmExpress\routes\goalRoutes.js", "JavaScript", 5, 0, 1, 4, 10
"d:\ABDOU\BrokerCrmExpress\routes\motivationRoutes.js", "JavaScript", 5, 0, 1, 4, 10
"d:\ABDOU\BrokerCrmExpress\routes\productRoutes.js", "JavaScript", 9, 0, 1, 3, 13
"d:\ABDOU\BrokerCrmExpress\routes\reportRoutes.js", "JavaScript", 8, 0, 1, 4, 13
"d:\ABDOU\BrokerCrmExpress\routes\serviceRoutes.js", "JavaScript", 5, 0, 1, 4, 10
"d:\ABDOU\BrokerCrmExpress\routes\specialityRoutes.js", "JavaScript", 5, 0, 1, 4, 10
"d:\ABDOU\BrokerCrmExpress\routes\statsRoutes.js", "JavaScript", 27, 0, 1, 4, 32
"d:\ABDOU\BrokerCrmExpress\routes\userRoutes.js", "JavaScript", 18, 0, 1, 4, 23
"d:\ABDOU\BrokerCrmExpress\routes\visitRoutes.js", "JavaScript", 9, 0, 1, 4, 14
"d:\ABDOU\BrokerCrmExpress\routes\wilayaRoutes.js", "JavaScript", 7, 0, 1, 3, 11
"d:\ABDOU\BrokerCrmExpress\stats\controllers\adminMonthController.js", "JavaScript", 94, 0, 3, 17, 114
"d:\ABDOU\BrokerCrmExpress\stats\controllers\delegateMonthController.js", "JavaScript", 222, 0, 6, 38, 266
"d:\ABDOU\BrokerCrmExpress\stats\controllers\supervisorMonthController.js", "JavaScript", 162, 0, 6, 22, 190
"d:\ABDOU\BrokerCrmExpress\stats\routes\adminMonthRoutes.js", "JavaScript", 10, 0, 1, 4, 15
"d:\ABDOU\BrokerCrmExpress\stats\routes\delegateMonthRoutes.js", "JavaScript", 27, 0, 1, 4, 32
"d:\ABDOU\BrokerCrmExpress\stats\routes\supervisorMonthRoutes.js", "JavaScript", 15, 0, 1, 4, 20
"d:\ABDOU\BrokerCrmExpress\utils\queryBuilder.js", "JavaScript", 48, 0, 0, 5, 53
"d:\ABDOU\BrokerCrmExpress\wilayas.json", "JSON", 0, 234, 0, 1, 235
"Total", "-", 3178, 3893, 72, 462, 7605